ABI	ABI						
AEOMICA	AEOMICA						
CASEADAMS	CASEADAMS						
CGAP-GAI	CGAP-GAI						
CHEVERUD	CHEVERUD						
CHINGNLAC	CHINGNLAC						
CRAMUS	CRAMUS						
DIFE	DIFE						
ENSEMBL	ENSEMBL						
ERO	ERO						
HGERSHENFELD	HGERSHENFELD						
IHBGSFLUFU	IHBGSFLUFU						
IMMUNOGENSVI	IMMUNOGENSVI						
JAXBEVPAIGEN	JAXBEVPAIGEN						
JSAM-COH	JSAM-COH						
KEENEY	KEENEY						
KJASZCZAK	KJASZCZAK						
KMRGMT	KMRGMT						
KOKORO_BIOLOGY_GROUP	KOKORO_BIOLOGY_GROUP						
LPG-NCI	LPG-NCI						
MATINLAB-MDACC	MATINLAB-MDACC						
MITCCR	MITCCR						
NAUMOVAEPI	NAUMOVAEPI						
NCBI-GENBANK-VAR	NCBI-GENBANK-VAR						
NDMCARDLE	NDMCARDLE						
OTAGOCGL	OTAGOCGL						
PARC_SEQ	PARC_SEQ						
PAWSNP	PAWSNP						
PERLEGEN	PERLEGEN						
PI_DPPM_INT	PI_DPPM_INT						
RIKENBSIMPS	RIKENBSIMPS						
ROCHEBIO	ROCHEBIO						
SC_JCM	SC_JCM						
SC_MOUSE_GENOMES	SC_MOUSE_GENOMES						
SIDJANIN	SIDJANIN						
TIZUMI	TIZUMI						
TOLLAB	TOLLAB						
TWGNF	TWGNF						
UNISTS	UNISTS						
UOL_CGR	UOL_CGR						
UTHSCSEQ	UTHSCSEQ						
VISION_GENETICS_LAB	VISION_GENETICS_LAB						
WI	WI						
WIMOUSESNPS	WIMOUSESNPS						
